Cupid
9,7
1,2,6
2,1,6
--xx-xx--
-x--x--x-
x-------x
-x-----x-
--x---x--
---xrx---
----x----


